B XXXXXXXXXXXXXXXXXXXXXXXXXX
X X      X                 X
X X XXXX   XXXXXXXXXXXXXXX X
X X X    X X               X
X X XXXX X X XXXXXXXXXXXXXXX
X X X    X X X             X
X X X XXXX XXX XXXXXXXXXXX X
X X X X        X           X
X       XXXXXXXXXXXXXXXXXX X
XXXXXXXXX    X X X       X X
X X       XXXX X XXXXXXX X X
X X XXX XXX  X X X       X X
X   X       XX   X XXXXX X X
XXXXX XXXXXXX  X X     X X X
X     X       XX XX XXXX X X
X XXXXX XXXXXXX     X      X
X       X       XXXXXXXXXXXX
XXXXXXX XXXXXXXXX        X X
X       X         XXXXXXXX X
X XXXXXXX XXXXXX XX   X    E
X         X         X   XX X
XXXXXXXXXXXXXXXXXXXXXXXXXXXX