XXXXXXXXXXXXXXXXXXXXX
B  X   X   X        X
 X X X   X X XXXXXX X
 X X XXXX  X X      X
 X      X XX XXXXXXXX
 XXXX X X         X X
 X    X XXXX X XX X X
 XX XXX X    X  X   X
 X  X X XX XXXX XXXXX
 XXXX X X  X        X
 X X    X XXXXX XXX X
 X X XXXX X     X X X
 X X X X  XXXXXXX X X
 X   X   X        X X
 XXXXXXXXX X XXXXXX X
E          X        X
 XXXXXXXXXXXXXXXXXXXX