XXXXXXXXXXX
B    XX   X
 XXX    X X
 X X XXXX X
 X      X X
 XXXXXXXX X
 X    X X X
 XX XXX X X
E         X
 XXXXXXXXXX